		

		NO 	    texture/1.xpm		


C 			212,255,0			
		
		  WE 			texture/3.xpm  



EA     	texture/4.xpm    	




	SO texture/2.xpm 

	F 45,30,255   













1111111111111111111111111
1000000000110000000000001
1011000001110000000000001
100010000000000000000000001111111
111111111011000001110000000000001
1000000000110000011101111111111111111111111111111
11110111111111011100000010001
11110111111111011101010010001
11000000110101011100000010001
10000000000000011000000100001
10000000000000001101010010001
11000001110101011111011110N0111
11110111 1110101 101111010001
11111111 111111 111111111111



