NO texture/1.xpm
    C 205,249,255
EA texture/2.xpm
SO texture/4.xpm
		 	 
	 	 	 
	 		 
		F 224,172,105
WE texture/3.xpm

        11111111111 11111111111111
        10000000001 10000000000001
        10110000011 10000000000001
        10010000000100000000000001
1111111110110000011100000000000E1
100000000011000001110111111111111
11110111111111011100000010001                  11111
11110111111111000001010010001                 1000001
1100000011010101111000000000011111             111111111111
100000000000000001 1000000100011111111111111111111
1000000000000000111010100100000000000000000000001
110000011101010111110111100011111111111111110001111111
1111011111110101110111101001                1000000001
11111111 1111111 111  11 111                1111111111